{
 "ff":{
   "8":"rr",
   "2":"vv",
   "4":"dd",
   "6":"gg",
   "7":"ee",
   "9":"tt",
   "1":"cc",
   "3":"bb"
 }
         
}